11,0,0,0,0,0,0,4,0,0,0,0,0,0,11
0,0,0,0,0,0,2,0,3,0,0,0,0,0,0
0,0,0,0,0,0,0,1,0,0,0,0,0,0,0
0,0,0,0,0,12,0,0,0,0,0,0,0,0,0
0,0,0,0,0,0,0,0,0,0,12,0,0,0,0
0,0,0,0,0,0,0,0,0,0,0,0,10,0,0
0,0,0,12,12,0,10,0,0,10,0,0,0,0,0
0,0,0,0,0,0,0,11,0,0,0,0,0,0,0
0,0,0,0,10,0,0,0,0,0,0,12,12,0,0
0,0,0,0,0,0,12,0,0,0,0,0,0,0,0
0,0,0,0,0,0,0,0,0,0,0,0,0,0,0
0,0,0,0,0,0,0,9,0,0,0,0,0,0,0
0,0,12,0,0,0,0,0,0,0,0,0,0,0,0
0,0,0,0,0,0,0,0,0,0,0,0,0,0,0
11,0,0,0,0,0,0,0,0,0,0,12,0,0,11
