x,x,x,x,x,x,x,x,b,x
x,c,c,x,x,x,x,x,x,x
x,x,x,x,x,x,x,x,x,x
x,x,x,x,x,x,x,x,x,x
x,x,x,x,x,x,x,x,x,x
x,x,x,x,x,x,x,x,x,x
x,x,x,x,x,x,x,x,x,x
x,x,f,x,x,x,t,t,x,x
1,2,x,x,x,x,t,t,x,x
3,4,x,x,x,x,x,x,x,x